ALB - AL - ALBANIA
DZA - DZ - ALGERIA
ARG - AR - ARGENTINA
AUS - AU - AUSTRALIA
AUT - AT - AUSTRIA
BHR - BH - BAHRAIN
BLR - BY - BELARUS
BEL - BE - BELGIUM
BOL - BO - BOLIVIA
BIH - BA - BOSNIA
BRA - BR - BRAZIL
BGR - BG - BULGARIA
CAN - CA - CANADA
CHL - CL - CHILE
CHN - CN - CHINA
COL - CO - COLOMBIA
CRI - CR - COSTA RICA
HRV - HR - CROATIA
CYP - CY - CYPRUS
CZE - CZ - CZECH REPUBLIC
DNK - DK - DENMARK
DOM - DO - DOMINICAN REPUBLIC
ECU - EC - ECUADOR
EGY - EG - EGYPT
SLV - SV - EL SALVADOR
EST - EE - ESTONIA
FIN - FI - FINLAND
FRA - FR - FRANCE
DEU - DE - GERMANY
GRC - GR - GREECE
GTM - GT - GUATEMALA
HND - HN - HONDURAS
HKG - HK - HONG KONG
HUN - HU - HUNGARY
ISL - IS - ICELAND
IND - IN - INDIA
IDN - ID - INDONESIA
IRI - IR - IRAN
IRQ - IQ - IRAQ
IRL - IE - IRELAND
ISR - IL - ISRAEL
ITA - IT - ITALY
JPN - JP - JAPAN
JOR - JO - JORDAN
KWT - KW - KUWAIT
LVA - LV - LATVIA
LBN - LB - LEBANON
LBY - LY - LIBYA
LTU - LT - LITHUANIA
LUX - LU - LUXEMBOURG
MKD - MK - MACEDONIA
MYS - MY - MALAYSIA
MLT - MT - MALTA
MEX - MX - MEXICO
MNE - ME - MONTENEGRO
MAR - MA - MOROCCO
NLD - NL - NETHERLANDS
NZL - NZ - NEW ZEALAND
NIC - NI - NICARAGUA
NOR - NO - NORWAY
OMN - OM - OMAN
PAN - PA - PANAMA
PRY - PY - PARAGUAY
PER - PE - PERU
PHL - PH - PHILIPPINES
POL - PL - POLAND
PRT - PT - PORTUGAL
PRI - PR - PUERTO RICO
QAT - QA - QATAR
ROU - RO - ROMANIA
RUS - RU - RUSSIA
SAU - SA - SAUDI ARABIA
SRB - RS - SERBIA
SCG - CS - SERBIA AND MONTENEGRO
SGP - SG - SINGAPORE
SVK - SK - SLOVAKIA
ZAF - ZA - SOUTH AFRICA
KOR - KR - SOUTH KOREA
ESP - ES - SPAIN
SDN - SD - SUDAN
SWE - SE - SWEDEN
CHE - CH - SWITZERLAND
SYR - SY - SYRIA
TWN - TW - TAIWAN
THA - TH - THAILAND
TUN - TN - TUNISIA
TUR - TR - TURKEY
UKR - UA - UKRAINE
ARE - AE - UNITED ARAB EMIRATES
GBR - GB - UNITED KINGDOM
USA - US - UNITED STATES
URY - UY - URUGUAY
VEN - VE - VENEZUELA
VNM - VN - VIETNAM
YEM - YE - YEMEN